11111111111111111111111
10100010001100001000001
10100010001100001000001
10100010001100001000001
1010C000110000001000001
100100001100001PE001011
10000C00000000101010001
11111111111111111111111