11111111111111111111111
10100010001100001000001
10100010001100001000001
10100010001100001000001
1010000011010C001000001
100101001101E00P0001011
10000000000000101010001
11111111111111111111111