11111111111111111111111
10000C0000C00000C0000C1
100000100000C00110C0001
111C00C00E001000P000001
10000C0000C0000011100C1
10000C0000C00000C0000C1
10000C0000C00000C0000C1
111C00C0000010000000001
10000C0000C00000C0000C1
11111111111111111111111