11111111111111111111111
10000C0000C00000C0000C1
100P00100000C0000C00001
111C00C00E0010000000001
10000C0000C00000C0000C1
10000C0000C00000C0000C1
10000C0000C00000C0000C1
111C00C0000010000000001
10000C0000C00000C0000C1
11111111111111111111111