11111111111111111111111
10000000000000000000001
10000010010000011000001
11100000E10100001000011
1000000000C000011110001
10000P0C000000000000001
10000000000000000000001
1110000C000000D00000001
10000000000000000000001
11111111111111111111111