1111111111111
10000C0000C01
100P001000001
100C00C00E001
1111111111111