11111111111111111111111
10000000000000000000001
10000010010000011000001
11100000E10100PD1000011
1000000000C000011110001
1000000C000000000000001
10000000000000C000D0001
1110000D000010000000001
10000000000000000000001
11111111111111111111111