111111111
10PC00111
1100E0111
111111111