1111111
101C0E1
1100P01
1111111