111111111
10P000111
10C0E0111
111111111