1111111111111111111111
100000000000CP00000001
100000000000C0000E0001
1111111111111111111111