11111111111111111111111
1C100010C01100C01DDDDD1
1C1D0010C01100C01D0DD11
1C100010C01100D01DDDDD1
101D000011CDDC01000C011
100101001101EDCP0001011
1C000000D00CDCD000000C1
11111111111111111111111