11111111111111111111111
1C100010C01100C01000001
1C100010C01100C01000001
1C100010C01100C01000001
1010000011C100C01000C01
100101001101E0CP0001011
1C000D0C0D00001C10100C1
11111111111111111111111