111111
101C01
10P001
1000E1
111111