11111111111111111111111
1C100010C01100C01D0C001
1C1D0010C01100C01D00D11
1C100010C01100D01000001
101D000011CDDC01000C011
100101001101EDCP0001011
1C000000D00CDCD000000C1
11111111111111111111111