111111111111111111111111
1000C0000000C0000D000001
10000C00D0C0000C0000DC01
100101000111D0000P000111
1001010001C1000000000011
100101000101001111111111
100101111101000000000001
10010000D001011111111001
100111110001010000000001
100000010001010111111111
1000000100010100000000E1
111111111111111111111111