1111111111
1000C00001
1000D00011
100P00E111
1111111111